53 33
#.............................................#
#............................#
#.................######.....#
#...........#    #...........#
#................#    #......#
#................#    #......#
#............................#
#................######......#
#................#    #......#
#................#    #......#
#................#    #......#
#............................#
#................######......#
#................#    #......#
#................#    #......#
#................#    #......#
#................######......#
#............................#
#................######......#
#................#    #......#
#...........#    #...........#
#...........#    #...........#
#...........######...........#
#............................#
#...........######...........#
#...........#    #...........#
#................#    #......#
#................######......#
#............................#
#................######......#
#................#    #......#
#................#    #......#
#@..................................................#