33 33
#............######......#
#...............................#
#............######......#
#...........#    #......#
#...........#    #......#
#...........#    #......#
#.......................#
#...........######......#
#...........#    #......#
#...........#    #......#
#...........#    #......#
#.......................#
#...........######......#
#...........#    #......#
#...........#    #......#
#...........#    #......#
#...........######......#
#.......................#
#...........######......#
#...........#    #......#
#...........#    #......#
#...........#    #......#
#...........######......#
#.......................#
#...........######......#
#...........#    #......#
#...........#    #......#
#...........######......#
#.......................#
#...........######......#
#...........#    #......#
#...........#    #......#
#@..........#    #......#