25 20





#############
#...........#    ########
#...........######......#
#.......................#
#...........######......#
#...........#    #......#
#...........#    #......#
#@..........#    #......#
#############    ########






